aaaaaaaaaaaaaaaaaaaaaaaaaaaaaaaaaaaaaaaa
a``````````````````````````````````````a
a``````````````````````````````````````a
a``````````````````````````````````````a
a``````````````````````````````````````a
a``````````````````````````````````````a
a``````````````````````````````````````a
a``````````````````````````````````````a
a``````````````````````````````````````a
a``````````````````````````````````````a
a``````````````````````````````````````a
a``````````````````````````````````````a
a``````````````````````````````````````a
a``````````````````````````````````````a
a``````````````````````````````````````a
a``````````````````````````````````````a
a``````````````````````````````````````a
a``````````````````````````````````````a
a``````````````````````````````````````a
a``````````````````````````````````````a
a``````````````````````````````````````a
a``````````````````````````````````````a
a``````````````````````````````````````a
a``````````````````````````````````````a
a``````````````````````````````````````a
a``````````````````````````````````````a
a``j```k```````````````````````````````a
a`````````````````````````````d```e``i`a
a``````````````````````````````````````a
a``````````````````````````````````````a
aaaaaaaaaaaaaaaaaaaaaaaaaaaaaaaaaaaaaaaa

