aaaaaaaaaaaaaaaaaaaaaaaaaaaaaaaaaaaaaaaa
a``````````````````````````````````````a
a``````````````````````````````````````a
a``````````````````````````````````````a
a``````````````````````````````````````a
a``````````````````````````````````````a
a``````````````````````````````````````a
a``````````````````````````````````````a
a``````````````````````````````````````a
a``````````````````````````````````````a
a``````````````````````````````````````a
a``````````````````````````````````````a
a``````````````````````````````````````a
a``````````````````````````````````````a
a``````````````````````````````````````a
a``````````````````````````````````````a
a``````````````````````````````````````a
a``````````````````````````````````````a
a``````````````````````````````````````a
a``````````````````````````````````````a
a``````````````````````````````````````a
a``````````````````````````````````````a
a``````````````````````````````````````a
a``````````````````````````````````````a
a``````````````````````````````````````a
a``````````````````````````````````````a
a``````k```j```````````````````````````a
ai````````````````````````````d```e````a
a``````````````````````````````````````a
a``````````````````````````````````````a
aaaaaaaaaaaaaaaaaaaaaaaaaaaaaaaaaaaaaaaa

